7 14 2 2
5 0 0 3 5 0 5 4 5 0 3 1 1 2 
2 3 3 2 5 2 5 1 2 5 2 4 5 2 
4 2 1 1 5 4 2 4 0 5 3 4 4 2 
2 4 1 2 1 5 0 5 0 3 2 3 5 1 
2 5 4 0 5 0 0 4 4 2 4 0 1 1 
0 0 4 0 3 3 2 0 4 1 1 0 2 4 
5 0 2 2 2 4 0 0 1 3 3 5 3 0 
4 8
3 7
2
10
1 4 3
