15 10 58 11
4 5 3 4 3 2 2 2 1 0 
0 3 2 0 4 2 3 1 5 0 
2 3 1 4 0 0 3 2 4 1 
3 2 2 1 5 0 1 0 0 3 
3 5 4 0 5 4 3 5 1 0 
0 0 1 3 2 1 3 2 3 5 
5 3 4 5 2 3 3 5 2 2 
3 5 1 2 3 1 1 0 2 2 
5 4 1 3 2 2 0 0 2 5 
2 0 5 1 1 0 5 5 2 4 
0 0 4 3 2 0 0 2 5 2 
3 2 4 5 4 2 2 1 5 5 
2 5 2 0 5 2 1 0 5 1 
1 3 0 0 5 4 0 2 3 1 
0 0 1 2 4 3 0 0 1 1 
1 2
9 5
5 2
4 2
8 1
11 4
13 2
14 4
2 9
14 3
13 3
5 4
6 0
8 0
3 7
5 3
5 1
10 6
9 4
13 5
6 5
6 2
0 8
13 6
4 5
7 9
14 5
8 3
11 1
14 9
7 7
3 8
7 2
8 8
11 9
6 1
11 3
2 4
4 4
12 4
12 6
9 2
14 2
12 5
12 9
0 6
1 0
3 9
13 9
7 6
1 7
1 3
9 1
0 1
12 2
11 8
4 8
9 3
3
3
9
5
2
7
10
4
1
3
10
7 1 2
