12 7 16 8
2 4 5 2 0 1 5 
5 1 2 5 2 5 0 
2 4 1 2 4 2 2 
2 5 3 4 2 2 3 
3 5 4 4 3 5 4 
4 3 0 3 5 4 1 
2 0 1 5 4 2 2 
5 4 0 2 5 5 3 
2 2 3 0 4 3 3 
3 4 2 4 4 1 0 
2 2 4 5 5 0 4 
2 1 1 2 2 1 0 
8 5
7 6
10 3
8 2
6 1
2 3
2 0
4 4
1 0
5 6
9 0
8 4
1 1
6 6
7 1
9 4
1
3
3
3
1
8
4
10
1 5 3
