9 12 36 15
4 2 1 2 5 4 2 1 5 5 0 1 
2 5 2 0 3 4 4 1 1 2 1 1 
3 4 0 5 1 4 1 3 3 2 5 3 
5 1 3 4 4 0 1 0 2 3 0 0 
1 0 3 2 3 5 0 3 3 2 5 0 
3 0 4 1 4 1 4 3 0 5 1 1 
5 5 0 4 5 3 1 2 5 2 1 5 
1 0 1 4 0 1 1 0 3 3 3 1 
1 1 1 2 3 4 2 5 4 5 1 0 
8 2
8 1
0 11
6 9
5 7
0 3
4 8
3 10
3 5
1 6
2 4
4 7
5 5
2 7
3 8
2 11
6 5
7 0
2 9
4 4
1 2
3 2
0 10
3 7
2 8
5 3
8 9
5 8
3 6
6 2
5 9
0 7
2 0
2 2
3 1
2 1
9
3
1
5
6
9
4
9
2
2
7
3
6
10
2
4 8 1
