15 5 5 9
4 3 0 0 0 
3 3 5 1 0 
3 2 3 1 3 
4 2 2 3 0 
5 2 3 1 3 
0 0 1 3 0 
3 2 5 1 0 
4 0 4 4 2 
4 3 5 2 2 
0 4 3 3 4 
5 1 3 5 2 
3 5 0 5 4 
4 2 0 5 3 
2 4 2 2 3 
4 4 4 3 4 
12 0
3 1
1 1
13 4
10 4
5
9
2
10
8
5
10
4
4
5 1 1
