14 12 22 3
4 0 2 4 0 4 2 2 3 5 1 3 
2 3 0 1 0 0 3 5 5 5 4 0 
5 3 1 0 2 5 2 3 1 4 5 3 
5 3 3 5 0 3 4 4 5 4 0 2 
0 1 2 4 2 0 0 0 4 3 2 2 
1 0 2 0 0 1 4 2 1 4 0 3 
0 4 5 2 1 3 1 0 0 2 1 2 
3 2 5 1 4 2 2 1 0 3 3 4 
0 4 3 4 4 2 5 5 4 5 0 5 
3 1 1 1 4 1 3 0 3 2 0 5 
0 0 4 3 2 5 5 3 4 4 1 5 
3 4 4 2 3 4 2 5 2 0 5 0 
1 0 1 3 1 5 3 5 2 0 4 5 
2 5 3 1 2 1 1 2 0 0 0 5 
6 4
7 1
3 7
5 9
13 4
13 1
5 2
12 4
7 4
3 11
3 6
8 0
2 9
5 7
2 1
9 1
12 10
9 8
10 6
2 4
9 11
2 11
1
10
6
2 3 1
