5 8 6 9
5 5 2 4 4 3 2 1 
3 3 4 0 3 5 4 3 
3 4 0 4 0 4 2 0 
4 5 1 3 2 5 0 5 
4 4 1 2 2 5 1 4 
1 3
0 6
4 1
3 3
4 4
1 7
7
9
10
10
7
2
3
3
8
3 7 0
