11 14 53 7
2 5 4 2 3 4 2 5 1 5 4 1 0 1 
0 2 0 2 1 0 2 1 2 0 0 3 4 1 
4 5 5 3 1 0 0 1 5 2 2 4 5 2 
4 2 2 4 0 1 2 4 4 0 4 3 2 4 
5 4 3 0 4 2 4 2 5 0 3 4 3 2 
1 2 5 2 2 4 3 0 4 4 1 0 5 5 
4 0 4 3 2 3 2 0 5 5 2 5 2 4 
4 3 1 1 2 2 2 2 4 3 0 1 3 3 
4 4 3 5 0 2 3 4 1 4 5 5 3 1 
4 1 5 3 4 3 1 4 3 2 2 1 4 3 
3 4 1 4 0 5 0 5 3 0 1 4 5 4 
8 1
0 6
1 1
9 8
6 13
8 13
8 7
1 7
6 4
8 4
4 4
3 10
9 7
5 12
6 10
2 12
4 11
4 1
1 10
7 1
1 13
2 11
6 0
8 0
5 6
4 5
8 5
3 6
9 0
4 12
6 8
1 3
7 6
6 9
8 2
7 13
6 2
4 2
8 6
0 1
5 4
2 4
0 11
8 12
7 7
4 10
10 5
3 5
0 12
4 7
5 8
10 3
5 7
10
10
9
6
7
10
9
0 5 0
