16 9 65 1
5 3 0 2 0 2 1 5 5 
1 5 5 3 1 3 0 2 3 
3 4 5 3 1 2 5 4 4 
5 4 1 5 2 3 0 2 2 
5 1 2 5 5 5 1 1 5 
4 1 0 4 3 3 3 0 0 
0 0 4 1 1 3 4 5 3 
2 5 1 2 1 3 0 3 2 
1 2 5 3 1 4 3 4 2 
2 0 0 3 1 4 0 5 1 
5 1 2 2 4 1 0 4 4 
5 2 4 4 4 3 1 5 5 
3 0 5 1 5 2 5 4 3 
5 3 4 3 2 0 3 4 2 
2 3 4 4 3 3 3 1 4 
4 4 1 5 2 2 3 3 2 
3 0
12 6
3 1
6 6
14 7
12 5
13 1
5 6
2 6
6 1
13 4
7 5
2 0
3 7
15 3
7 3
9 3
1 5
2 7
1 6
5 1
11 6
3 8
8 6
4 1
9 8
8 8
13 8
7 0
5 2
2 4
2 5
10 7
6 8
12 0
4 2
13 5
0 6
11 1
15 7
1 1
11 7
8 1
0 7
9 2
14 1
8 7
11 0
6 0
12 1
8 0
1 4
0 2
2 3
5 0
11 4
3 4
11 5
5 3
4 5
2 8
2 2
15 2
9 5
8 4
9
5 6 2
