10 15 34 9
1 1 2 4 4 0 3 3 4 5 0 3 0 4 4 
5 1 1 0 3 1 5 0 5 5 3 3 2 2 1 
0 0 0 4 3 1 4 2 0 0 0 3 5 0 3 
4 2 0 3 3 0 1 1 0 0 0 0 2 3 3 
1 1 1 5 5 2 1 0 5 5 5 2 5 0 1 
4 0 3 2 5 0 0 3 2 0 1 3 4 5 4 
2 1 2 2 4 1 1 3 4 3 2 3 4 5 5 
1 3 1 4 3 3 3 4 1 2 1 5 1 5 1 
1 0 2 3 3 2 4 5 4 3 1 4 0 5 5 
5 5 4 3 4 1 5 5 0 1 1 0 4 2 0 
4 13
0 8
8 6
1 5
0 2
3 13
0 1
4 5
1 12
6 6
4 12
4 1
5 12
4 10
8 14
8 13
5 11
3 8
4 14
1 14
3 1
2 2
1 13
2 0
2 11
9 5
2 6
8 4
0 3
8 3
5 14
7 6
0 4
6 0
8
3
1
5
9
7
6
10
5
1 5 0
