15 9 15 1
3 0 2 0 2 5 5 2 4 
4 0 0 3 5 1 3 3 3 
5 2 5 5 5 0 0 2 0 
1 4 2 1 5 1 5 2 0 
4 3 1 1 2 2 2 2 5 
2 4 5 1 0 4 0 4 2 
1 5 0 1 3 3 3 5 0 
0 2 0 0 5 0 4 1 2 
5 4 2 3 0 4 0 1 0 
1 2 0 1 3 1 0 1 1 
0 5 3 1 4 2 1 0 1 
1 3 4 1 3 0 2 3 4 
2 2 3 4 0 5 5 4 0 
5 3 3 4 2 2 1 0 3 
0 0 5 5 4 2 2 0 0 
1 6
1 5
13 2
1 4
1 3
12 5
14 0
14 3
9 2
6 3
4 5
13 3
7 6
4 4
13 1
7
10 1 2
